悪	tên ÁC nhân không có Tâm tính đã trèo qua 亜(hàng rào)
屋	Với ý Chí(至), tôi đã Thi trèo lên cao ỐC 
億	Âm thanh oan ỨC của 1 người k có trái tim thì 100 triệu người cũng không ai tin
安	Phụ nữ ở nhà là AN toàn nhất
暗	Hắc ÁM công hội được Lập ra từ song Nhật thần giáo
案	làm đề ÁN An toàn nhất vẫn là treo lên Cây
意	Âm thanh của trái Tim chính là Ý chí của bản thân
委	UỶ viên trung ương đảng bắt những đứa trẻ đi gặt lúa
医	Y học là mũi tên chỉ Phương hướng chữa bệnh
以	Dĩ
位	Người đứng đầu thường có VỊ trí rất cao trong xã hội và họ luôn biết tự lập
胃	Đêm Trăng tròn mà ra ngoài Ruộng là đau VỊ tràng
囲	tôi chắp tay xin tiền bố mẹ trong phạm VI chấp nhận được 
衣	Y - y phục
塩	Diêm vương thích dùng muối đất và bát đĩa phải có hình súng và mồm
院	tôi đã hoàn thành xong bãi đất cát trong bệnh viện
員	nhân VIÊN thích ăn xò = mồm
飲	Ẩm -ẩm thực
横	Trục Hoành được làm từ gỗ màu vàng
央	Ương -trung ương
愛	Ái - tình ái
温	1 ngày ÔN hòa là ngày có đủ nước để rửa Bát
運	mọi người VẬN động = cách dùng chiếc khăn kéo oto đi từng bước
育	Dục - giáo dục
駅	Ngựa điên phá phách làm DỊCH chuyển nhà ga hình chữ R
泳	Vịnh - bơi
栄	vòng nguyệt quế VINH quang được làm từ cây
英	Anh - tiếng anh
印	Ấn - ấn tượng
荷	Hà - hành lý
貨	tôi biến Hóa từ con sò ra hàng HÓA
課	kết Quả của KHÓA học nói này rất bất ngờ
加	Mọi người hợp lực tham gia để vác ô vuông này
果	Quả  - kết quả
化	Hóa - biến Hóa
害	với cái Miệng bà Chủ Nhà, nó đã gây tổn HẠI rất lớn đến tiền của
街	Nhai - đường phố
覚	tôi phát GIÁC ra rằng con Kiến có 3 sợi lông cu 
各	Các - các vị

開	Khi đến với cổng trời, bạn sẽ được KHAI vận
界	Giới - thế giới
階	GIAI cấp được so sánh = vùng đất và Bạch lượng sở hữu
械	tôi chắp tay nhìn Qua máy CƠ giới chặt cây
改	Tôi CẢI cách đám trẻ tự Kỉ này = cách đánh khẽ vào đít
感	1 lần Qua sườn Núi hình Vuông thì phải CẢM tạ thần tình yêu
館	Quán - hội quán
寒	Hàn - lạnh
漢	Hán - hán tự
関	Cổng trời liên QUAN tới con bọ cánh cứng
完	Hoàn
管	Quản
官	Quan
観	Quan
岸	Ngạn
願	Nguyện
起	Khởi
期	Kỳ
喜	Hỷ
季	Quý
旗	Kỳ
紀	Kỉ
希	Hi
機	Cơ
器	Khí
議	Nghị
客	Khách
急	Cấp
級	Cấp
球	Cầu
究	Cứu
救	Cứu
泣	Khấp
求	Cầu 
給	Cấp
宮	Cung
去	Khứ
挙	Cử
橋	Kiều
競	Cạnh

共	CỘNG
協	Hiệp 
鏡	Kính
業	Nghiệp
曲	khúc
局	CỤC
極	CỰC
銀	Ngân
苦	Khổ
区	Khu
具	Cụ
君	Quân
訓	Huấn
軍	Quân
郡	Quận
軽	Khinh
係	Hệ
型	Hình
径	Kính
景	Cảnh
芫	NGHỆ 
血	Huyết
決	Quyết
結	Kết
欠	Khiếm
県	Huyện
研	Nghiên
健	Kiện
建	Kiến
験	Nghiệm
湖	Hồ
庫	Khố
固	Cố 
幸	Hạnh
向	HƯỚNG
港	Cảng
康	KHANG
候	Hậu
功	Công
好	Hảo

航	Hàng
号	Hiệu
告	Cáo
芽	Nha
根	Căn
差	Sai
皿	Mãnh
祭	Tế
最	Tối
菜	Thái
村	Tài
昨	Tạc
殺	Sát
刷	Loát
札	Trát
察	Sát
参	THAM
散	Tản
産	SẢN
残	Tàn
指	Chỉ
始	Thủy
歯	XỈ
死	Tử
詩	THI
仕	Sĩ
使	Sử
氏	Thị
史	Sử
試	Thí
士	Sĩ
司	TY
次	Thứ
持	Trì
事	Sự
治	Trị
児	Nhi
辞	Từ
式	Thức

写	Tả
者	Giả
失	Thất
実	Thực
借	Tá
酒	Tửu
守	Thủ
主	Chủ
取	Thủ
種	Chủng
受	Thụ
習	Tập
拾	Thập
集	Tập
終	Chung
州	Châu
周	Chu
重	Trọng
住	Trú
宿	Túc
祝	Chúc
順	Thuận
初	Sơ
暑	Thử
所	Sở
助	Trợ
消	Tiêu
昭	Chiêu
章	Chương
商	Thương
勝	Thắng
唱	Xướng
笑	Tiếu
燒	Thiêu
松	Tùng
賞	Thưởng
象	Tượng
照	Chiếu
省	Tỉnh
乗	Thừa

植	Thực
身	Thân
進	Tiến
申	Thân
深	Thâm
真	Chân
神	Thần
信	Tín
臣	Thần
世	Thế
整	Chỉnh
清	Thanh
静	Tĩnh
成	Thành
全	Toàn
席	Tịch
積	Tích
昔 	Tích
節	Tiết
折	Chiết
説	Thuyết
戦	Chiến
選	Tuyển
浅	Thiển
卒	Tốt
巣	Sào
相	Tương
送	Tống
想	Tưởng
争	Tranh
倉	Thương
息	Tức
速	Tốc
束	Thúc
側	Trắc
続	Tục
族	Tộc
孫	Tôn