#5k_P1
音	Âm thanh ngày thành lập đất nước rất rộng ràng, vui vẻ
雨	T + M = Trời mưa như VŨ bão
雲	雨 (rain) + 云(bộ vân) Trước khi trời mưa => Có vân vân đám mây
引	Phải kéo dây cung DẪN đến mũi tên
遠	袁(viên) Bước đi trong khuôn viên, vĩnh VIỄN 1 đi xa không trở về
夏	Vào mùa HẠ, Mắt tôi luôn Truy tìm 1 con ve
家	Mái nhà che chở những con lợn là GIA đình
花	1 người cầm thìa xéo cỏ thì gặp 1 bông HOA
園	Khuôn VIÊN được vây quanh là công VIÊN
料	Tôi lấy nguyên LIỆU từ 2 Cân Gạo
歌	欠(Khiếm - thiếu), 可(Khả - có thể). Vẫn có khả năng CA hát cho dù bạn thiếu đi tài năng
画	Quay ngược chữ lại giống như HỌA sĩ đang vẽ, Kế HOẠCH là cho nổ bom TNT trong 1 cái hố
空	Công phu bấm huyệt là KHÔNG đạo, trống rỗng tâm hồn
魚	Bắt CÁ(NGƯ) với một lưỡi câu ở trong ruộng, sau đó nướng với lửa
具	Mắt là dụng CỤ để đọc chữ K
語	5 cái miệng nói ngôn NGỮ #
午	2 + 10 = 12h => Giờ NGỌ
後 	Truy lùng phía sau cái xích là yêu HẬU
楽	nghe NHẠC/bị LẠC ở trên cái cây có ánh sáng Trắng lấp lánh
気	 メ(me = tôi) tôi có 1 KHÍ, đó là khí chất
記	Ngôn từ bản thân tôi được lấy trong nhật KÝ
帰	Tôi QUY ẩn giang hồ, mặc kệ đao kiếm
見	Con KIẾN có đôi mắt nhìn được đôi chân mình
汽	Hơi nước kết hợp từ KHÍ + nước

#5k_P2
会	[人=NHÂN, 云=VÂN] Trong ngày HỘI gặp mặt có nhiều người và mây
絵	[糸=sợi chỉ, 会=Hội] HỘI triển lãm có nhiều bức họa được đan chỉ rất đẹp 
回	Cái hộp xoay quanh 1 HỒI bên trong cái hộp to hơn
海	Một người đăng nằm để kéo lưới trên biển(HẢI)
外	quốc Tịch muốn nhập NGOẠI vN thì phải xem bói bên ngoài 
金	1 người dùng xẻng đào đất để tìm VÀNG(KIM)
近	Nếu bạn bước lại CẬN tôi, tôi sẽ bổ Rìu vào bạn
今	Cử 1 người mang cây KIM ra đây ngay bây giờ
間	Mất 1 ngày để đi đến giữa GIAN cổng trung tâm
角	Tôi sử dụng 1 chiếc móc câu để GIÁC ngộ
活	Sinh hoạt = cách liếm lưỡi để uống nước
教	[孝=Hiếu thảo] Tôi GIÁO dục con có đức tính hiếu thảo = cách đánh khẽ nó
強	Tôi bắn cung 1 con bọ trên tấm CƯỜNG lực riêng 1 mình
兄	Huynh - anh trai
京	Những người sống ở KINH đô thì Đầu to và miệng Nhỏ
原	Nguyên nhân Tiểu Bạch mã bị rớt ở Sườn Núi là do ngu
元	Số Pi quay NGUYÊN 1 vòng vẫn là số Pi
計	Lập KẾ hoạch tán Khánh Vy thì cần ít nhất 10 ngôn ngữ
形	Tôi Chắp tay 1 lần xin được xem được HÌNH dạng mái tóc dài của cô ấy
国	Xung quanh QUỐC gia toàn chứa bảo Ngọc
黒	HẮC thủ bịt mặt đốt cháy Làng đen xì
顔	Với mái tóc dài đứng trên vách núi, NHAN sắc cô ấy đẹp tuyệt trần như trong trang giấy
岩	Núi fun ra NHAM thạch
丸	Chín hình 丶 gộp với nhau sẽ HOÀN thành 1 hình tròn
古	10 cái hộp từ thời CỔ xưa rất đáng giá
交 	Bạn là sự GIAO nhau của đầu khấc của bố và xxx of mẹ
校	HIỆU trưởng trồng cây giao thoa với lớp học
広	Mái nhà của sự Riêng tư là ở QUẢNG trường thời đại
光	Pi phát ra 3 ngọn lửa ánh sáng(QUANG)
公	8 người riêng tư trong khu vực CÔNG cộng
考	5 công an cầm cái que định vị để KHẢO sát xung quanh ngôi mộ bí ẩn
高	CAO - chiều cao[Tưởng tượng hình ảnh tường thành]
黄	HOÀNG hậu phái quân Xe đi bắt con Sò về để ăn
合	Ngôi nhà là sự hòa HỢP của vk ck

#5k_P3
左	Naruto đã có công sức chống lại TẢ(bên trái) luân nhãn
算	Hãy Chắp tay cầu nguyện và nhắm Mắt để tính TOÁN số cây Trúc trong khu rừng
作	1 người đã làm nên 1 chiếc chìa khóa kiệt TÁC
細	TẾ công gầy như Sợi Chỉ sống bên Ruộng
才	Tài - tuổi, thiên tài
姉	Tỷ tỷ của tôi là đứa con gái hay cầm kiếm
紙	Thị ngân CHỈ tay vào sợi tơ đẹp
市	Biên giới của 1 thành THỊ luôn cắm đầy Kiếm 
思	Ở dưới ruộng mới có Tâm TƯ
室	Phòng THẤT và mái nhà sắp xếp rất Chí lý
字	trên mái nhà, những đứa Trẻ biết Tự học Chữ
寺	Phải TỰ đo lường ngôi chùa bao nhiêu m2 đất.
時	Ngày hôm nay là THỜI gian đi chùa
社	Trong XÃ hội này, Neji dùng thổ độn
首	Bản thân là THỦ tướng mà cái cổ như chữ K nằm.....
周	hình dạng CHU vi biên giới lãnh thổ là hình vuông
週	Mỗi tuần, tôi đi CHU du khắp nơi
秋	mùa THU là mùa ta đốt lúa gạo
書	Mỗi ngày, tôi đều lấy Bút viết vào thiên THƯ
止	tôi Chỉ có 1 lý do CHÍNH đáng
少	bọn tài Phiệt là rất ít, THIỂU số thôi
場	lãnh Thổ con linh Dương có TRƯỜNG ở Nhật bản
出	mọi người Há mồm khi Mầm non được XUẤT ngoại
#5k_P4
林	sơn LÂM nấp trong 2 bụi cây
森	củ SÂM được tìm trong rừng sâu
新	tôi cách TÂN cái Rìu để có thể Đứng dậy để chặt Cây
親	người THÂN luôn Nhìn tôi tự Đứng dậy sau mỗi lần vấp ngã ở gốc Cây
春	3 người đang đi chơi Ngày XUÂN
弱	Song cung và song cánh là vô địch, k có NHƯỢC điểm
数	Người phụ nữ gánh lúa bị đánh vô SỐ tội
西	Người phương TÂY toàn nói về số Pi
青	Thanh - màu xanh
星	người TINH tế luôn sống 1 ngày rất ý nghĩa
声	âm THANH của những người Thi Sĩ rất đặc biệt
晴	TÌNH yêu là những Ngày trong Xanh, trời nắng đẹp
赤	Ngựa XÍCH thố có 4 đôi chân
雪	mặc KỆ trời mưa, TUYẾT vẫn rơi
切	Thất kiếm làng sương mù có thể cắt(THIẾT) mọi thứ
先	Tiên - trước, tiên sinh
船  


